25 20
#########################
#.....z.....#.....z.....#
#...........#...........#
#...........#...........#
#####d#############d#####
#....e.............e....#
#..........s.s..........#
#.....###################
#..k..#
#..g..#
#.....###################
#.........s..........s..#
#...e.......e...........#
###################.....#
                  #..i..#
                  #..g..#
###################.....#
#.@...........s.........#
#.......s...............#
#########################
